R 640 480
NO ./textures/kanji/north.xpm
SO ./textures/kanji/south.xpm
WE ./textures/kanji/west.xpm
EA ./textures/kanji/east.xpm
S ./textures/barrel.xpm
F 220,100,0
C 12,214,250






1111111111111111111111111111111111111111111111111111111111111111111111111111111111111111
1222222222222122222222222222222222222222222222222222222222222222222222222222222222222221
1222222222222122222222222222222222222222222222222222222222222222222222222222222222222221
1222222222222122222222222222222222222222222222222222222222222222222222222222222222222221
1222222222222122222222222222222222222222222222222222222222222222222222222222222222222221
1222222222222122222222222222222222222222222222222222222222222222222222222222222222222221
1222222222222122222222222222222222222222222222222222222222222222222222222222222222222221
1111111111112122222222222222222222222222222222222222222222222222222222222222222222222221
1222222222222222222222222222222222222222222222222222222222222222222222222222222222222221
1222222222222222222222222222222222222222222222222222222222222222222222222222222222222221
1222222222222222222222222222222222222222222222222222222222222222222222222222222222222221
1222222222222222222222222222222222222222222222222222222222222222222222222222222222222221
1222222222222222222222222222222222222222222222222222222222222222222222222222222222222221
1222222222222222222222222222222222222222222222222222222222222222222222222222222222222221
1222222222222222222222222222222222222222222222222222222222222222222222222222222222222221
1222222222222222222222222222222222222222222222222222222222222222222222222222222222222221
1222222222222222222222222222222222222222222222222222222222222222222222222222222222222221
1222222222222222222222222222222222222222222222222222222222222222222222222222222222222221
1222222222222222222222222222222222222222222222222222222222222222222222222222222222222221
1222222222222222222222222222222222222222222222222222222222222222222222222222222222222221
1222222222222222222222222222222222222222222222222222222222222222222222222222222222222221
1222222222222222222222222222222222222222222222222222222222222222222222222222222222222221
1222222222222222222222222222222222222222222222222222222222222222222222222222222222222221
1222222222222222222222222222222222222222222222222222222222222222222222222222222222222221
1222222222222222222222222222222222222222222222222222222222222222222222222222222222222221
122222222222222222222222222222222S222222222222222222222222222222222222222222222222222221
1222222222222222222222222222222222222222222222222222222222222222222222222222222222222221
1222222222222222222222222222222222222222222222222222222222222222222222222222222222222221
1222222222222222222222222222222222222222222222222222222222222222222222222222222222222221
1222222222222222222222222222222222222222222222222222222222222222222222222222222222222221
1222222222222222222222222222222222222222222222222222222222222222222222222222222222222221
1222222222222222222222222222222222222222222222222222222222222222222222222222222222222221
1222222222222222222222222222222222222222222222222222222222222222222222222222222222222221
1222222222222222222222222222222222222222222222222222222222222222222222222222222222222221
1222222222222222222222222222222222222222222222222222222222222222222222222222222222222221
1222222222222222222222222222222222222222222222222222222222222222222222222222222222222221
1111111111111111111111111111111111111111111111111111111111111111111111111111111111111111