R 640 480
NO ./textures/kanji/north.xpm
SO ./textures/kanji/south.xpm
WE ./textures/kanji/west.xpm
EA ./textures/kanji/east.xpm
S ./textures/barrel.xpm
F 220,100,0
C 12,214,250

1111111111111111111111111111111111111111
1222222222222222222222222222222222222211
1222222222112222222222221111111111111211
1222222222112222222222221111111111111211
1222222222222222222222221111111111111211
1111111111112222222222222222222222222211
1222222222112222222222222222111111111111
11112222222222222N2222222222111111111111
11112222222222222222222222221
11222222222222221122222222221
12222222222222221122222212221
12222222222222221121212212221
11222221112121211111211112221
11112111 1112121 121111112221
11112111 1111111 111111111211
11112111111111111111111111211
11112111111111111111111111211
11112111111111111111111111211
11112222222222222222222222211
11111111111111111111111111111