R 640 480
NO ./textures/lodev/colorstone.xpm
SO ./textures/lodev/eagle.xpm
WE ./textures/lodev/greystone.xpm
EA ./textures/lodev/mossy.xpm
S ./textures/barrel.xpm
F 220,100,0
C 12,214,250

1111111111111111111111111111111111111111
1000000000000000000000000000000000000011
1000000000110000000000001111111111111011
1000000000110002020020001111111111111011
1000000000000000000000001111111111111011
1111111111110000000000000000000000000011
1000000000110000000000000000111111111111
1111000000000000000000000000111111111111
11110000000000000000000000001
11000000000000001100000000001
10200000000000001100020010001
10000200000000001101010010001
11000001110101011111011110001
11110111 1110101 101111110001
11110111 1111111 111111111011
11110111111111111111111111011
1111N111111111111111111111011
11110111111111111111111111011
11110000000000000000000000011
11111111111111111111111111111